#O#####################
#OOOOOOO#########OOO###
#######O#########O#O###
###OOOOO#..OOO###O#O###
###O#####.#O#O###O#O###
###O....#.#O#OOOOO#OOO#
###O###.#.#O#########O#
###OOO#.#.#OOOOOOO#OOO#
#####O#.#.#######O#O###
#OOOOO#.#.#OOOOOOO#OOO#
#O#####.#.#O#########O#
#O#OOO#...#OOO###....O#
#O#O#O#######O###.###O#
#OOO#O..#....O..#.###O#
#####O#.#.###O#.#.###O#
#OOOOO#...#OOO#.#.#OOO#
#O#########O###.#.#O###
#OOO###OOO#OOO#...#O###
###O###O#O###O#####O###
#OOO#OOO#O#OOO..#..O###
#O###O###O#O###.#.#O###
#OOOOO###OOO###...#OOO#
#####################O#